{
    "map": {
        "tile size": 20,
        "tiles": [
          ["6",   "4",    "4",    "4",    "4",    "4",    "4",    "4",    "4",    "4",    "6.R"],
		  ["4.L", "8",    "8",    "8",    "8",    "8",    "8",    "8",    "8",    "8",    "4.R"],
		  ["4.L", "8",    "8",    "8",    "8",    "8",    "8",    "8",    "9.L",  "8",    "4.R"],
          ["4.L", "8",    "8",    "8",    "8",    "9.L",  "8",    "8",    "8",    "8",    "4.R"],
          ["4.L", "8",    "8",    "9.LL", "8",    "8",    "8",    "8",    "8",    "8",    "4.R"],
          ["4.L", "8",    "8",    "8",    "8",    "8",    "8",    "8",    "8",    "8",    "4.R"],
          ["4.L", "8",    "8",    "8",    "8",    "8",    "8",    "8",    "8",    "8",    "4.R"],
          ["4.L", "8",    "8",    "8",    "8",    "7",    "8",    "8",    "8",    "8",    "4.R"],
          ["4.L", "8",    "9.LL", "8",    "8",    "8",    "8",    "9.L",  "8",    "8",    "4.R"],
          ["4.L", "8",    "8",    "8",    "8",    "8",    "8",    "8",    "8",    "8",    "4.R"],
          ["4.L", "8",    "8",    "8",    "8",    "8",    "8",    "8",    "8",    "8",    "4.R"],
          ["4.L", "8",    "8",    "8",    "8",    "9",    "9.R",  "8",    "8",    "9.R",  "4.R"],
          ["4.L", "8",    "8",    "8",    "8",    "8",    "8",    "8",    "8",    "8",    "4.R"],
          ["4.L", "8",    "8",    "9.R",  "8",    "9.RR", "8",    "8",    "8",    "8",    "4.R"],
          ["4.L", "8",    "8",    "8",    "8",    "8",    "8",    "8",    "8",    "8",    "4.R"],
		  ["6.L", "4.LL", "4.LL", "4.LL", "4.LL", "4.LL", "4.LL", "4.LL", "4.LL", "4.LL", "6.RR"]
	   ]
    }
}